11111011111                   01100110
1001001001001001001*******************
        111111111111111111111111111111