111110111111111
11111100111
11 1111
