11111011111                   01100110
1001001001001001001*******************


11111011111                   01100110
1001001001001001001*******************