NO textures/test/north.xpm
SO textures/test/south.xpm
WE textures/test/west.xpm
EA textures/test/east.xpm

F 0,0,0
C 0,0,0

1111111
1000001
100N001
1111111
