F 253,76,76

C 199,99,155

NO textures/simonkraft/cobblestone.xpm
 
SO textures/simonkraft/cobblestone_01.xpm

WE textures/simonkraft/mossy_cobblestone1.xpm

EA textures/simonkraft/cobblestone_02.xpm


1111111111111111111    
1001001001001000011   
1010010001001000011             
1011000001000001001111 
1001000S0011001000001111  11111111111       
10011110011100100100101       1110000111
100001111  111111111111 11 11 1 11111111 11 11 1
1001111111111001001        1111111111
1111000000000001011
1000000001000000001
1111111111111111111





