F 0,0,0
C 255,255,255

NO textures/test/north.xpm

SO textures/test/south.xpm

WE textures/test/west.xpm

EA textures/test/east.xpm


11111111111111111111111111
111111111111111111111111111
110000000000000000000000001  
110000000000000000000000001
11000000000000000000000001
110000000000000000000000001
110000000000000000000000001
1100000000000010000000000001
110000000010000000000000011
1100000000100000000000000001
110000000000000000000000001
110000000000000000000000001
1000000000N0000000000011111111         
111111111111111111111111
