F 0,0,0
C 92,10,10

NO textures/simonkraft/netherrack_01.xpm

SO textures/simonkraft/netherrack_02.xpm

WE textures/simonkraft/netherrack_02.xpm

EA textures/simonkraft/netherrack.xpm


11111111111111111111111111
110000000000000000000000001
1100011111110100000000000001
110000000000111111111110001
110000000000000000000000001
111111100000111111111110001
110000000000000000000111101
1100001111111000000000000001
1100000000111111111110000001
110000000010110100000000001
110000000010000100000000001
110110000010000100000000001
1E010000000000000011111111
11111111111111111111
