F 0,0,0
C 255,255,255

NO textures/simonkraft/bookshelf_01.xpm

SO textures/simonkraft/bookshelf_01.xpm

WE textures/simonkraft/cobblestone.xpm

EA textures/simonkraft/cobblestone.xpm


11111111111111111111
1111111111111111111
11111111111111111111
1111111111111111111
11111111111111111111111111
110000000000000000000000001  
110000000000000000000000001
110000000000000000000000001
110000000000000000000000001
110000000000000000000000001
110000000000000000000000001
110000000000000000000000001
110000000000000000000000001
1100S0000000000000000000001
110000000000000000000000001
10000000000000000011111111         
11111111111111111111
