F 0,0,0
C 255,255,255

NO textures/simonkraft/warped_planks.xpm

SO textures/simonkraft/warped_planks.xpm

WE textures/simonkraft/cobblestone.xpm

EA textures/simonkraft/cobblestone.xpm


11111111111111111111111111
110000000000000000000000001  
110000000000100000000000001
110000000000100000000000001
110000000000000000000000001
110000000000000000000000001
110000000000000000000000001
110000000000000000000000001
110000000000000000000000001
110000000000000000000000001
110010000000000000000000001
1000N000000000000011111111         
11111111111111111111
