F 0,0,0
C 255,255,255

NO textures/simonkraft/bookshelf.xpm

SO textures/simonkraft/bookshelf.xpm

WE textures/simonkraft/cobblestone.xpm

EA textures/simonkraft/cobblestone.xpm


11111111111111111111111111
110000000000000000000000001
110000000000100000000000001
110000000000111111111110001
110000000000000000000000001
110000000000000000000000001
110000000000000000000000001
110000000000000000000000001
110000000000000000000000001
110000000000000000000000001
110110000000000000000000001
1N010000000000000011111111
11111111111111111111
