F 76,76,76
C 199,99,99

NO textures/simonkraft/cobblestone.xpm

SO textures/simonkraft/cobblestone_01.xpm

WE textures/simonkraft/mossy_cobblestone1.xpm

EA textures/simonkraft/cobblestone_02.xpm


11111111111111111111
1111111111111111111
11111111111111111111
1111111111111111111
11111111111W11111111
10000000000000000001  
10000000000000000001         
1000000000000000001         
10000000000000000001         
10000000000000000001         
10000000000000000001         
10000000000000000001         
10000000000000000001         
10000000000000000001         
11111111111111111111
