F 76,76,76
C 199,99,9910

NO textures/simonkraft/cobblestone.xpm

SO textures/simonkraft/cobblestone_01.xpm

WE textures/simonkraft/mossy_cobblestone1.xpm

EA textures/simonkraft/cobblestone_02.xpm


11111111111111111111
10W1001001001000001         
1011000001000001001111
100100000011001000001111  11111111111       
10011110011100100100101       1110000111
100001111  11 111111111 11 11 1 11111111 11 11 1
1001111111111001001        1111111111
1111000000000001011
1000000001000000001
1111111111111111111





