F 76,76,76
C 199,99,99

NO textures/simonkraft/cobblestone.xpm

SO textures/simonkraft/cobblestone.xpm

WE textures/simonkraft/cobblestone.xpm

EA textures/simonkraft/cobblestone.xpm


11111111111111111111
1111111111111111111
11111111111111111111
1111111111111111111
11111111111W1111111111
11000000000000000000001  
1110000000000000000001         
11110000000000000000001         
11111000000000000000001         
1111110000000000000001         
1111111000000000000001         
1000000000000000000001         
1000000000000000000001         
1000000000000000000001         
1111111111111111111111
