F 0,0,0
C 0,0,0

NO textures/simonkraft/noir.xpm
SO textures/simonkraft/noir.xpm
WE textures/simonkraft/noir.xpm
EA textures/simonkraft/noir.xpm

111111111111111
1S0000000000101
1011110111110101
1000000100000001
1111111110111011
1000000000100011
1011111011111011
1000001010000001
1111111010111111
1000000000000001
1110111111111101
1000100000000001
1111111111111111
