F 0,0,0
C 0,0,0

NO textures/simonkraft/noir.xpm
SO textures/simonkraft/noir.xpm
WE textures/simonkraft/blanc.xpm
EA textures/simonkraft/blanc.xpm

111111111111
1S0000000001
1110111011101
1000100000101
1011111110101
1000000010101
1011111010111
1000000010001
1110111110101
1000000000001
1111111111111
