F 0,0,0
C 0,0,0

NO textures/simonkraft/noir.xpm
SO textures/simonkraft/noir.xpm
WE textures/simonkraft/noir.xpm
EA textures/simonkraft/noir.xpm

11111111111111111
1S0000000100000001
1111111010111111101
1000000010000000001
1011111011111111101
1000000010000000101
1011111110111111101
1000000000100000001
1011111110111111111
1000000000000000001
1111111111111111101
1000000000000000001
1110111111111111111
1000100000000000001
1111111111111111111
