F 0,0,0
C 0,0,0

NO textures/wolfenstein/eagle.xpm
SO textures/wolfenstein/grey_stone.xpm
WE textures/wolfenstein/mossy.xpm
EA textures/wolfenstein/mossy.xpm

1111111111111111111111111
10W0110000100000000000001
1000110000000000111111001
1000110000000000110001001
1000000000100000000001001
1111111111111111111111111
